.,......,...,,.,,,,,,,,,,,******,,,**,,,,,,,,,,,,,,,,,,,,,,,,,,,,,,,*,,,,,**,*****,,**,*,,,,........,,..,.......,,..  ..... . . ....,,...,.,........,,..................,,...,,,...   ......  ..
..,,,,.,,.,...,..,,,,,,,,*,,,,,,,,,,,,,,,,,,,,,,,,,............,....,,,.............. ...                                                        &/. @   /.               ....,.....       .
,....................,..,,,,,,,,,.....,,.........                                                                                              .%&&@##@#@&(/((
.......,..................... ........... .                                                                                                   %%#%%%%%#%,%#(@&##.
.. ....           .      .     .                                                                                                            /(%%%%#%%%##%#%%#&&@@@&
.  ...                                                                                  //(#*(                                              .((((##(((( /./  /,/./,#&(#(/
                                                                                    *(((//((/*/(/                                           .((//((//#/  /.##&((&&,##&%%&&    &#*.
                                                                                ///(((#(/////(///.                                          .///////////(,.,,@%*(/**/#//((   &&&#(/
                                                                                #(/(/((((//(///(/,                           ,..,,**//((#/#////%#%/#//*%&#((#//**///(*#*//#/****,(**///***/(***/****///*
                                               .,*//(*.  ....,,,,,***,**,,**,,,,,***/***///*////***,*,*,**,,...,..,.,,...,*,,,,,,**.,. ,..,,*,/*,***,**,,,,.,..,,,.,.,,**#/%&%(,,,,./*****,*,/*,,*/*,*,*
   . . .*,,,****/*/////////*//*////**/*/****/,**,.,,,,.,,,,,.,,,,,,,,,,,**,***,,*,,,*,,,,,*****,**,,,,....,..,,,,..,.,..,,,...,...,,,,,,,.,*,,*,.*..,.,,,.,*,**,,,,,,..,*.,.,,.,,,,.,.,,,,,,.,,,,,,,...,
*(***//***/////******///*/*******///**/,.... .. .,     ...,.,....,,,.,.,,,,,......*,,..,,,,..,,,,,,.,,,,,,,**,.**,,,***,..,.,.....,,,,,....,,*,,*.,,.,,,,.*,,*.*...,,...,*/.*..., ,.... . ..... ..   . .
*/,,*,,,,**,**,,,/*****/*,,,***//, ,.....,..     .   .    .    ............................,.,,.*,,..,.,,,..,,....,,.*.,.,....,........... .,,,..,,*,,,,*.,/,....,.,.... ..,..,..,.. ............,..,, .
**,*,***,,*,**,,,,**,**/**//................. ... .. . ..   .  .....,........,.....,...,.......,.,.....,,........,,,*,..,,,,.......,.,,.,..,. ,.. ,.,,.,..,,,,*,.(/,*..  ..... .  ....,..........,,.,..*
*//*,,**,*,***********,/,.,,,,. ..,.. . ...,...... .. . .      ......,,,,,.....,,,,.,...,,,,,....  ........,,,..,,.,...,..,. .. ....... ......,,,,...,,,..*,.,.,. ........**,.......,,,,,,****.,,,,.****
****.,,*,*,*********/,,.,,.....,,..,.........   . .....,......,.,....,.,..,,,*,,...,,*,.*......,..,...,.,..,.,,,.,,*.,..,.,.. .,...,,,*,**,/*********(/**/*/*,*,.*,/***,***,*,*,, (*//////**//*/***,,,,,
,**,*,,**,,*/.,***//*,*,,,**,,,,,*...,,,.,....,.,...  .. ..,..,,,*,,,,.,,,,,,,,,...,,*,*,.,,,**/**/.,,,*/,/*********,..,,,**.,.,,,****/*****,*/**/**,,*//*/*//,**//*/****,**,,**/***,**********,.*,%%#*(
//*//*/**/**,/*(*/*//***.,,,.,,*,,,,.,,,..,..,.,....,,....,.,,,/*,,/**,***/*****,,,***,,,*,*.*************,.*,******,*,.,,,*,,,,,,//*******/**/./***,,*,*/*,,,,,*//*****,,,****.. /*.,,,,**,,,,,**,*/*/*
,/********/*/*//**////****/**,*/**.,,,,*,**,,*,*,.,*/*******/*******/**,,*/***,**,/**,,**,***,*/*******,**.,*.*,,***,/,,.,,***,,****,.,,.,*.,**//,*/**,*,/**.***,*,**,*/*****,*,**,*,,*,**,,,,*****/*/**
///*****//*,/***/******/*/(//(**/*/*/***/*/*/,*/*/**/*,,*/*****,/.*********,//***,,,**,/,*,.**,,*/***,***,*,*,,*/*,**,*,*,**,*,**,***,,,,*/,,,,,,*/***,,.,.,*,*.,*,*,*,,,,*,***,*,,**,*,*****,********,*
*(#**//******//*,//******//*/**/***/**/**/*******//*,******,,**,*/,,/,***,******/****/***,,,****,******/**,***,,/*******,***/*,,*/******.,,**.,*,,****,,,,,,**.,,.....,,,**,*,****,***/**/,*,*,*,**/****
///*/**********(*//(***/***//***//*/**,*******/*,//********,*,********,*,***/,,,*,.,,**,*****,***,,,*.*,,*.,*,,,,**,**,*.,,,,*/,,/**.***,,,,,,,,***,.*,,,..,*.*,,*,***,,*,***,//*,*/*//**/**,*/**,,*****
**//*,*/**/*,,,***/////****,****/,**,*****,*,/*,****/*,//************/***,,*,,,***,*,,,.,.,,,.,,*,,*,*,*,*,,,*,,***,,,,*,**,*,.,,,***,//,**,,*,**,,****,,/*//*,,/*,***,/*******,,,*****,/**********,,/**
*/*/**,*/**/*,**,**/(****************//*///**/.***//*****,,,**/*****/**/**/*,,,***,,,*,,**..,,,,,,....,,,.**,,.,,...,*,*,,,,,,/**,//****/*/,*,*******/,,*,**,***********/******,**,,*****,*,*,****/***,*
/*/*(////****/*/***//%/****/****/***/*,**/((,****,*/****,(*/***/,*(***,,*,*,,,**,***,***,.,@&&%&&&(,.,*,,**/**,**,****.,*/**,/*,***//***,****/,,*,,.,,*.,,,*/(,*****,*/**/**,,/,*,***,/**/*,**/,*.***,**
//(#//*/**.****//*(******//*///***,**,**,,/,,/,**/(/,,*/.***,*//******,*,,,***,,,,.,,,,.#@@@&**%%@@#,*/***/*,*,**,,*/********(*(.(/*****//*/(/*(***,**/*/,,,(***/,*/,*/**/*//*********,*,****,////,**,**
*(*//**//**(*****,,,***,/****,*****/*,/*/****,*/,//,***/*/**,*******.,,*,*,****,*,.*.,.*@@&@&#@&@/&@*(*,*/(*,*/*,****,*,,./*,**,,,,.*/,****/,******(//**(***/*,,,*,,/*,,*********,***,*/,*/*//***,*//**/
****,,****//**,.,.***/(*(/*//../*,**//*/*,*,,**(,*/*.,**,**,/*,,**.,**,,*,**/,.*,*,,,,/(@%@&@&%%&&&%,**/(*,,/***/*,***/*,*,*,,******,,,*,***/**/**/*,/*,***,**/,,***,*/****,*/,/***/*,*,*,//,,,//*/(****
//****,/**/(////.,*,,*,,//(*(,//*,*,/,/*(/***,***,*(,,,*..*(*,/,*,(*,.*,.,*,,***,,..,*/&%&&&%/%&@&&,*,.*,*****/(*,***,*.(**,*/***,/*,**(/,**///,*/,*.*,****/,*,*,**,*//*,/,*/*/*****,***.*,******/****/(
*/***/(*//**(**/***,/***/***,******/(/*,//,*,*,/**/*,,//**//****,*,,****,,*,,./,,*,,(@&&@@%@&@&&#&,,**(///********,/**,***,/,,****/*,,**,***./*/,///*,,,**/,/****/*,**/***,*,*,//**,******/*//**(///****
/#/(/.*(/((*,#,*/#**/,//*/*,,*/***.,*,,/*****,*,,******/****/*//.,,*/*,*****,.***/* /@@@@&& ,   ./*****(///,***,**,*,****,/,*,*/(****//(***,,*,***/,***,*,,,***/*,//,,*//*/*****/*/***,,***/**/*/,**,*//
/##*#/(%/(/&,/**/*/,***./**,,,*(*,*(,/*,**,,,*,*,,/,*,//***/***/**,.*.*(,*,/**/***,./*           /***//,*,,**,///,//,/*,**,***********,**/****,*,*,/*//***,*/**/*******//**/(*,,,***,**,/***,***/***,,,*
***********(%* ************,,*,*,/*,,**,*,,****/*.***,*/*/**///,*,**,******,/*//,.           /     (*/********//*,,/*,*******/(*,/,,,/*,,*******,,//*/*/,*/,,**/*,*/**/***/*,//*/***,/,/,,******/*****/*
******/(*.*,**.,/,,**/**,./,*/,,.***,,.****/*,,,*/*,,,,(,,****/**.,,**/,,*/(///           ,,       (*,**///**/***/****(,/,***/,***,..,,,*,,/*/*/,*,*,***,(,*,/*,,*,/****,,,*****.*,,,*,(,,****,*(//**,/*
**./*,,,**(**,*,,./,****,**.*/*,#***,**,,*/*/,/*/,**..****/(/*.(/**/,*,,*//(#..         (*  */    //*//////,*/****,,/***/,/***/*,,**,***,,*,,*/*/,***,*,,**/*/**///,*,(***,.,**/.*,/*//,****/*,,**/(//*,
*/*,/,*/*/*/(*//*,*,*****/***/****(,*/*,..(*.,,,,,*,,,,*,**///*(//*,/,   #.  ..... .* ,*%%*    /,(,,/*,.***,**/**/****/**/*/**/,*********#****/*///**,,,*/**//*****,/,,,*,*******,******,*,,((**/**//***
,,.*,(*,/*%*///(//***/,**//***,(*(,,/,*,**/**,,*/,*//*(/,/,*/*              @..,..     (.   (/,*.  .,.*///,***,***,/,***/***/,,/(**/*/*,//******//*/,*,***//*/*,,**/****.,**,/(*/*(.***,**,**,(,,,//***/
**,////,,***(*#***/*(*/(/*,*#/(/****,**,/,*,**/,*/ .,,,,**,**.,,.         . . @&.&%%%.   %((///##%@%%@&(//*/******/*,*/,/**,*/*,*/**//*/,((,*///**/(**,****,,*****//*,,***,***/*****,*****,/,****,,**,/*
*,.//,/*(*/(*/*./,(***,/**/,*(////,,/***/,,/*/** .,/.,,*/**/*/,/*,      .       @&@ ,.  &&#/*(,****/*,*****/***,**,,/(***,*//*,***////*,*,*,*,*,,******/,,**.,,***/*******/*.,(/**//,/,*((/,**/,,/*,*,*/
.//((*//(/,*,,,,/,***,,****///(((*/***,*/**,**,,,,#(/*/(*,**/((/*,..           &#  (*  (/***,**//**/*/***,***********//,*/*****/*.//**////*//****,,*,*,,**,**,,,/*,*****/**/*****,/(**///,***(*,**/**(*/
****/****,(/((**,*/*///*,****/*,*////,.*,,.##*,*////%*/,/////#%//**/. .*      #(*./(, ,////*/*./*/,(**#*/*/(/*,/,*,*,*(***/******/*/*****//***(,**//*,,**,*/**/****/,/*(//*********(/**,/***,**//*,,/***
*,*/*,/*,*(*****/*/*//**(**///,*,*/((*@,   //&@&&@*/*(%%//*///(*((//.,%/  ,*//(*/*/*  //*/*/**/**/,(*//***/,*,,/*,****,******************,/**,*,**,*/,,*/*,*,/***,//*******//*/*//***//**,*****,**,(//*,
*,**/#,*/*/,*,///**//**,/.@@%#/..(..*/  .*//*.**//@@&,.,/((%#/#%&/(%#/(**(%%#/,,/**,  (*/,,***/,,/(/*/,/*/*****,*,***/,****,*,**.***.******(,,//****/***,/,*/*(*,**,***,***,#**,**/,*/,*,/****/**/,,****
.***/**(/*,**,(/**(//**(#//%&%##&@@@%(*/,,//,,*,./,..*,.,.,.**,.*.,//*/((##%#*/(%((* , ..,*,*//*((*/*//*,,,//******,//,**/****/*.***,,*,,,**//*//**/.***,**/***,*/***/*,/*///*/**///,,/******,,/**,**,,*
,,**,/..,,****#(/#*,(*/*/*,*,/****/*/*.,.*,,.*/**,,.,,***,***&****/*/,,***********#/,*,,/ *,/*//***/*//(/,/(**.(*,****./***,(*.,//////(/,//*((*/***(*,,(*,,****/,*,,******,/**/*/,**/,**(//*(***///*//*(
*,****,/*/,,*/,*/,,,(//****,*/(*(*,,,,*,**,*,**/**,,**(.,,*,*/,*,*,,/*,*//,**/(*****#***/,**********,****//*(,*,******/**//***/*/*//,*/****(((*/(*/*,*/*******/**//**,.*,*//*/*,,****(&/*/,***,(//*/****
(**/,,*,.(##*/*,**/***/(***,****/,,,,,/,*(,,*****,**/*,,**/.*(,/*,*,.*//*.(*//(/**/*,/*,*,,**/,*/*/.,/*,*/**/****(*.,//*/*,*/*,**,//(*(/**,.(/,/////(*/*,*/****//,*/*,***,/*,**/*/*/,/***,/**/*//,*/,***
**(/,*(,//,,**/**/*/,,(*,*/**,/,**,,***/,/*,***(,,,**/,/,*/(,*,,./,,/*,*,*,***/,/*,/./*/,/**,/****/,,,/*****//,/*//,*(*///(**/,(*,(**//#*,(/**/*,,,///****/*,***,,,/.**,*/**/**#/*,*,,**/*/*****/***/*/*
#/((/*,,*,@(/#***,/,/#*/***,***/*,*,/,.*/*(,/*(,,**/(((//*(/,**(,/./,,*/*,/,,*/,,****/(.,**,/**/.,/,**/***,,******/,*/%//(/#%/,,**(//***/**/***/**,///(*(,*/**,.**,***,**//**,*,(*/*,,**/,/***.**,/***//
/,,**/*/*/**/***,///,*(//,((**.(/*/,(,**,*/*,**/***/*(/*//(*,%***,..***//,*/./,#,,..*/*,,,,,*,,*/(****#/**,/,/,(*(/**((**##(,*/*/(*,.***/(*(,,/,*////(/*,//((/*//,/*/.,,##*((*,**(#**//.//.*//(*(*(#**,,
/.*(**(*.*/,***,*,(.,*,/(//**,,..**.*,///,/*(*****/****,,(*((*,*/././,*.*,*,.(.,,.**/(*//,**,*,*.//,*//**(**.,,//#**/((/(**%/,**,,**/**/*,,.*,**,***/*,(*#*(//,*.**,/,,//(*//*,,*,*,/.,*****,/,((*/,//*/
*/*#,(****(*./*/(/*/*/,/,*(**(**,**,(***/**/,*,/,,,/(//,,,/*,#(/*/,,*,,(/*,*,*,*,,,*(/(/*/,,,*//,(///#((*//..*//**//,(%*//(*(*.*/,,/*//**((///.,,**//,*(/((((/(%*//,**./**//**/,///*#/,////**,(///(/#/*/
/#*/#(,,*/*,/*/*////*#*%,.******,,(#,(#(/,/**,,#*(*,**/**(/*/,((*((**,(/****/#,%//*/,*//#,***,/*,(**/*((*(**(///#*,(,##(**((/***/(*/*/*(/((/,*/,#*/((((,/,,//(%*#//(,,//(//(**(*(#*((((#/*(/*(**(*#(#/*,
#(/*#*,(#/(/*,/(#/*//////,/*(#**//**((/(%**/*(%*#%//*,/(/*//**#((/,#*,*#/(///(//#(/(//(*//,/(,/*,*//(/(%%///%*(/((*##/#(/##%//,(#/(/(#(*#((%#//**/(#/#***/#(##*/*(*(/**/((%/%/#/%/(#(#/#/**/#(((*/*((#/*